000000000000000000000000000000000000002222222220000000000000000000000000000000000000000
000000000000000000000000000000000022222222222222222000000000000000000000000000000000000
000000000000000000000000000000222222222222222222222222000000000000000000000000000000000
000000000000000000000022222222222222200000000000222222220000000000000000000000000000000
000000000000000000022222222222220000000000000000002222222000000000000000000000000000000
000000000000000002222222222222220000000000000000000222222000000000000000000000000000000
000000000000000002222222222222222000000000000000000022222000000000000000000000000000000
000000000000000002222222222202222220000222222222220022222000000000000000000000000000000
000000000000000002222222222222222222022222222220022202222000000000000000000000000000000
000000000000000002222222222222222200222222222220022222222000000000000000000000000000000
000000000000000022222002222222222200222222222000022222222000000000000000000000000000000
000000000000000222222222222222222220222222220000222222222000000000000000000000000000000
000000000000002222222222222222222000222222222222222222222000000000000000000000000000000
000000000000022222222222222222222222222222222222200222220000000000000000000000000000000
000000000000222220000000000222222222222222222000002222220000000000000000000000000000000
000000000002222200000000000000000000002222222000002222220000000000000000000000000000000
000000000022222200000000000000000000000000000000022222200000000000000000000000000000000
000000000222222000000000000000000000000000000000222222000000000000000000000000000000000
000000002222220000000000000000000000000000000000222222000000000000000000000000000000000
000000002222200000000000000000000002222000000002222220000000000000000000000000000000000
000000002222000000000000000000000022222022200022222200000000000000000000000000000000000
000000002222000000000000000000000022222222220022222000000000000000000000000022222222200
000000022222000000000000000000000022222222200222220000000000000000000000002222222222220
000000022222000000000000000000000222222222202222200000000000000000000000222222000022220
000000022222000000000000000000000222222222002222200000000000000000000022222220000222220
000000022222000000000000000000002222222220022222200000000000000000002222222000002222200
000000022222000000000000000000002222222200022222222222222222222000222222200000222220000
000000002222000000000000000000022222222000022222222222222222222222222220000002222200000
000000002222000000000000000000022222220000022222000222220002222222222000000222222000000
000000002222000000000000000000222222220000002220002222222222222222200000022222200000000
000000002222200000000000000022222022222000000000222222222222222222000002222222000000000
000000000222200000000000002222200222222200000000022222222222222222220002222222200000000
000000000222220000000000002222222222222200000000000000000000022222222000022222222200000
000000000022222000000000000222222222222000000000000002222000000022222200222202222200000
000000000022222200000000000000222200000000000000000002222000000002222220022222222000000
000000000002222220000000000000000000000000000000022200000000000000222220000222200000000
000000000000222222220000000000000000000000000000222200000000000000222220000022220000000
000000000000000222222200000000000000000000000000222200000000000000222222222222220000000
000002220000000022222222220000000000000000000000022220000000000022222222222222200000000
000022222220000222222222222222220000000000000000002220000000002222222000020000000000000
000022222222222222022222222222222222222200000000000222200002222222000000000000000000000
000022220222222222222220000222222222222222022222222222222222222200000000000000000000000
000002222002222222222000000000222222222220222222222222222222200000000000000000000000000
000000222200022222200000000022222222222202222202222222222200000000000000000000000000000
000000022222222220000000000022222222222002222000000000000000000000000000000000000000000
000000002222222000000000000002222222200022220000000000000000000000000000000000000000000
000000000022200000000000000002222220000222200000000000000000000000000000000000000000000
000000000000000000000000000000222222002222000000000000000000000000000000000000000000000
000000000000000000000000000000022222222220000000000000000000000000000000000000000000000
000000000000000000000000000000000222222200000000000000000000000000000000000000000000000
000000000000000000000000000000000002220000000000000000000000000000000000000000000000000
